■ワイヤレス

WLC		集中管理型のWLANにおいて使用されるデバイス。複数台のAPを一元管理することができる
集中管理型AP	AP自身は電波の送受信のみを行う。設定・制御については、WLC（WLANコントローラ）がまとめて行う
自律型AP		IOSが動作し、AP単独でWLANを提供できる各APでそれぞれ設定・制御を行う
CSMA/CA		WLANにおけるコリジョンを回避する通信方式
SOHO		小規模なネットワーク構成
BSS
BSSID		無線LAN（Wi-Fi）における無線アクセスポイント（AP）および無線ネットワークの識別子の一つで、48ビットの値。通常はアクセスポイントのMACアドレスをそのまま用いる。
ESS
ESSID		無線LAN（Wi-Fi）における無線アクセスポイント（AP/親機）および無線ネットワークの識別名。32文字（バイト）までの英数字で構成され、ネットワーク管理者が任意に設定することができる。複数のAPが同じESSIDを名乗り、同一のネットワークを構成することもできる。
ローミング		契約している通信事業者のサービスを、その事業者のサービス提供範囲外でも、提携している他の事業者の設備を利用して受けられるようにすること。
CAPWAP		WLCとAPの間で通信制御を行うためのプロトコルの一つ。
■FHRP

HSRP		Cisco独自のプロトコルで、デフォルトゲートウェイを冗長化するために使われる
VRRP		ルータの冗長化のためのプロトコルで、標準化されているプロトコル
GLBP		Cisco独自のプロトコルで、仮想MACアドレスは「0007.b40x.xxyy」
アクティブルータ	複数のルータをスタンバイグループとして見せかけていて、実際に転送処理をしている１台のルータ
スタンバイルータ	アクティブルータのバックアップとなるルータ。
■QoS

輻輳管理		通信ネットワークに許容量を超える伝送要求が殺到して混雑状態になることを管理すること。
輻輳回避		輻輳によって起こるテールドロップを防ぐためにキューに待機しているパケットを破棄すること
テールドロップ	キューがいっぱいになったときに、それ以降に届いたパケットはすべて破棄してしまうこと
帯域制御		特定の基準をもとに使用できるデータ転送量や通信速度を制限できること
シェーピング	主にデータを送信する側で実装するもので、決められた制限レートを超えるパケットは一旦キューに保持しておいて、送信可能になったタイミングで送信するもの
ポリシング		主にネットワークの入り口部分で実装するもので、制限レートを超えるパケットは破棄されます。
■WAN

VPN		仮想的なプライベートネットワーク接続のこと。
インターネットVPN	インターネットを利用するVPNのこと
サイト間VPN	拠点間のLAN接続するためのVPN接続のこと
リモートアクセスVPN	モバイル端末やテレワークの際に自宅から社内のネットワークに接続されるためのVPN接続のこと
IPsec		インターネットVPNでよく使用されて、ネットワーク層で動作するプロトコル
GRE		個別のネットワーク間の接続を簡素化するために、ネットワーク全体で直接ポイントツーポイント接続を設定する方法の1つ
クラウド		コンピュータリソースをインターネットなどを介して、サービスの形で必要に応じて利用する形態
SaaS		サーバ上で機能するアプリケーションまで含めた全てをクラウド事業者が管理提供するサービス
PaaS		アプロケーション開発環境などのミドルウェアまでを備えた形で提供されるサービス
IaaS		物理サーバ・ネットワーク・OSのインフラ部分のリソースだけが提供されるサービス
■セキュリティ

脆弱性		コンピュータやソフトウェア、ネットワークなどが抱える保安上の弱点
脅威
マルウェア
ウイルス		コンピュータの正常な利用を妨げる有害なコンピュータプログラム
ワーム		インターネットなどを通じてコンピュータに侵入し、さらに他のコンピュータへの自身の複製を試みるもの
トロイの木馬	何らかの有用なソフトウェアなどを装って導入や実行を促し、起動すると利用者に気付かれないよう秘密裏にデータ漏洩や遠隔操作などの有害な動作を行うソフトウェア
スプーフィング
DoS攻撃		大量のデータや不正なデータを送りつけて相手方のシステムを正常に稼働できない状態に追い込むこと。
DDoS攻撃		インターネット上の多数の機器から特定のネットワークやコンピュータに一斉に接続要求を送信し、過剰な負荷をかけて機能不全に追い込む攻撃手法
中間者攻撃	通信を行う二者の間に割り込んで、両者が送受信する情報を自分が用意したものとすりかえることにより、気付かれることなく盗聴したり、通信内容に介入したりする攻撃手法
ソーシャルエンジニアリング	コンピュータシステムにアクセスするために必要な情報（パスワードなど）やその手がかりを、それを知る本人や周辺者への接触や接近を通じて盗み取る手法
ブルートフォースアタック	暗号の解読やパスワードの割り出しなどに用いられる手法の一つで、割り出したい秘密の情報について、考えられるすべてのパターンをリストアップし、片っ端から検証する方式
WPA
WPAパーソナル	WPA-PSKとは、無線LAN（Wi-Fi）の暗号化を行うWPAのパーソナルモードで、アクセスポイントと端末で事前に共有した秘密の符号によって接続認証や暗号化を行う方式
WPAエンタープライズ	IEEE 802.1X標準に基づくRADIUS認証サーバを利用し、個々の利用者に個別に発行されたパスフレーズによって認証
サプリカント	ネットワーク上の利用者や端末の認証において、認証を要求する側（クライアント側）の機器やソフトウェアのこと。
オーセンティケータ	認証器、認証子、認証符号などの意味を持つ英単語。
認証サーバ	システムの使用やネットワークへの接続を試みた人物が登録利用者本人であるかを確認する「認証」（authentication）を行うサーバ
多要素認証		MFA
知識要素		パスワードや暗証番号など本人しか知らないはずの情報を用いる「WYK」
所持要素		乱数表やUSBトークンなど本人しか持っていないはずの物品（モノ）を用いる「WYH」
生体要素		指紋や虹彩など人体の特徴を用いる「WYA」
AAA		情報システムが利用者を識別し、利用者に応じた制御を行う際に重要な要素を表した標語
Authentication	相手が名乗った通りの本人であると何らかの手段により確かめる本人確認のこと
Authorization	コンピュータシステムの利用者に特定の操作権限を付与する処理や手続きを指すこと
Accounting	利用状況や履歴を記録し、課金や利用制限などに反映させる活動のこと
RADIUS		大規模なネットワーク認証システムの構築に用いられるットワーク上で利用者の認証や権限の付与、利用状況の記録などを行うための通信プロトコル